1 2 2  1  1  1  1  7  1  2  2  1  1  1  1  7  1  2  2  1 1 50
1 1 1  7  6  7  0  0  1  1  1  7  6  7  0  0  1  1  1  7 1 50
0 0 1  0  0  0  0  0  0  0  1  0  0  0  0  0  0  15 1  0 0 50
0 0 0  0  0  0  0  5  0  0  0  0  0  5  0  0  0  0  0  0 0 50
0 0 0  0  0  0  0  9  0  0  0  0  0  9  0  0  0  0  0  0 0 50
0 0 0  0  0  0  0  8  8  0  0  0  8  8  0  0  0  0  0  0 0 50
0 0 0  0  0  0  0  2  1  0  0  0  2  1  0  0  0  0  0  0 0 50
0 0 0  0  0  0  0  1  10 0  0  0  1  10 0  0  0  0  0  0 0 50
0 0 0  0  0  0  0  10 10 0  0  0  10 10 0  0  0  0  0  0 0 50
0 0 0  0  0  0  0  1  1  0  0  0  1  1  0  0  0  0  0  0 0 50
0 0 0  0  0  0  0  0  0  0  0  0  0  0  0  0  0  0  0  0 0 50
0 0 0  0  0  0  0  0  0  0  16 0  0  0  0  0  0  0  0  0 0 50
0 0 0  0  0  0  0  0  0  0  0  0  0  0  0  0  0  0  0  0 0 50
3 1 1  3  3  3  3  1  3  3  1  3  3  3  3  1  3  3  1  3 3 50
2 2 1  1  2  2  1  1  2  1  1  1  2  2  1  1  2  1  1  1 1 50